137
.o....o.o.o.o.o.....o.ooo..o...o..
oo..o..oo.....o....o..o.....oo..o.
..o...o..o..o..................o..
o....o.............o.....o..o....o
.oo......o..................o...o.
o....o..o.o....o.o........oooo....
.o.o.....oo..ooo.o...ooo.o........
......o........o.o.o.....o..o.oo..
..........oo..o.......oo...oo....o
.o.oooo..o.o.o.o.o..o..o.....o.o.o
...oo..o.o.......o..o...o.o.oo....
o..oo..........o.o.o.....o.oo.....
.oo.o.......o.....o.o...o.o.......
.o.o.o..o....o..o.o.....o...o.....
.oo...o............o.....o........
..o...oo.oo.o....o....oo..o.......
.o.o.......ooo......o...o..o......
.oo..........oo.....o.o..o........
oo...o..oo.oo......o..oo.o..o.....
o.....o..o..oooo.......o..oo......
......o..o..o.....oo.o....o....oo.
o.....o.o..o..o.o.o.oo..o.......o.
o..o.......o.ooo.....o..ooo.oo.o.o
oo.......o.........o...oo.o...o..o
............o..........o.o.o.o.o..
.ooo.ooo..o.ooo...oo.oo...ooo.....
.ooo...o...ooo..ooo.o.....oo..oo..
...o...o.....o.o.o...oo..o..oo..o.
....o...o....o..oo.o........o..o.o
....oo..o.ooo.o.o..o..o..o......oo
...o...o..ooo...o.......o.....oo..
...o.o.o..o.o.....o...ooo...o..oo.
.o...ooo............o......o......
o....o.oo.oo.........o...o.o.o...o
o.o.o........o...o........o.......
o........o..o...o.......o.........
.............o......o..o.oo..ooo..
.oo.......o.....oo..oooo..........
.......o.....o..o...o...oo..oo.ooo
o..........o...o.o.....o......o...
....o...oo..o.o.o.o..ooo.......oo.
....o....o..o..o.....oo..o...o...o
.oo.o............o..o...ooo..o....
o...o..........o..o.oo.o.o........
..o.oo.o....o....oo.o.............
..o...o.ooo.o...oo.......o..o..o..
oo.o.....oo..o......o....o.oo.....
....o.....oo..oo.........o......oo
...........o..o........oo..o..oo..
oo..o..o.ooo......o......oo......o
..........o..oo.oo..o...........oo
o.o..oo...o..oo.....o..oo.o......o
..o......oo..oo....ooo..oo......oo
o.o.....ooo..oo...o.o......o...o..
...o...o...................o.o....
o...o....oo.............o.o.......
..o.o..o....o......o.ooo..ooo.....
....o....oo.o.......ooo..o.....oo.
o......o......oo.oo...ooo..o.oo...
.o.o......o.....o.o.o..........o.o
...........o....o...o...o...o....o
..o....o..o..o..oo.oo.o.o..ooo..o.
.oo.o.............o......o........
....o...o..o...o.o.......ooo..oo..
.......o..o..ooo............o.....
..o................ooo.o....o..ooo
o.o...o.ooo.o..o...oo...o...ooo...
..ooo.oo....oo...o....oo..o..o....
.o....oo.o..o..o...o.......oo.....
....o..o..o..o..o...........o...o.
..oo...oo..o...o..o.o..ooo...o....
......o.oo...o....o.o.......o..oo.
o.o.o........oo.oo..oo..oo..ooo...
......o......o...o.oo..o..........
...o......o..........oooooo..o..oo
....oo....o..o.o..o....oo....o....
....o.oo.o.o..o.oo.....o..oo.....o
..o.....o.oo..o.oo.o.....o.o..oo..
.....oooo........oo....oo.....oo..
..o...o.oo.oo....o...o.o....ooo...
..........oooo.o...oo.o.......o.o.
....o....oo.......oo...o.o..o....o
.o..o...o.....o..o.oo......o.o....
o..oo..o.oo..o.........ooo.....o..
........oo..o....o..o.oo.o..o....o
..o....ooo.....o.oo....o.....o.o..
o..o...oo.ooo.....o.....ooo...ooo.
......ooo.o..o...o...o.....o....oo
.o............o....ooo....oo......
o...o.o........oooo....o...o.o....
...........o..oo.o......o.o..o...o
o..oo.o...oo.o...o...o...o.o...ooo
.........o..o.o.o..........o.....o
...o.......o.ooo...oo..........o..
......o......o...o..o.o.ooo.o...oo
....oo....o.o...o...oo.oo....o....
o.oo.o.....oo.oo.oo........o......
.o....o..oo..........oo.........oo
........o.....oo.o................
...o..ooo.....o..o....o.o..o.o....
......oo..oo..oo..oo..oo...o..oo..
.....o................o.........oo
..o.o....oo....o......oo.oo.o.....
.o...o...o.......o.........o..o.o.
........oo..o..o..o..o..o.ooo.....
.o...o.o...o....o...o.o....oo.....
..o......o.....o...o.o..oo.o...o..
oo..o..o..o...o...o.......oo....oo
.....oo.o.......o.o..oo...o.o..o..
o..o.oo..........o...oo....o....o.
......o.oo......o........o....oo.o
oooo.oo...........oo.o..o.o.ooo.o.
......o.....o..o..oo..o..o....o..o
.o..oo.oo.o.o.o....oo.o...o....o.o
....o....o......oo...o.o..o.o.o...
.ooo..........o..o...o.oo......o..
o....o..o....o..........o..o....o.
......o.o..o..........o..o......oo
o...o.oo.o..........o.o..o..o....o
.............o.....o..oo.....o.o..
.o.........o..oooo................
oo.......o..o.....o.....oo........
.....oo..o...o.o..o......o.......o
......o........oo..o...oo....o....
..........o.....o...o.....o.......
oo....o..o...oooo......o.ooooo....
.......ooo....o...ooo..o....o.oo..
.oo..o...o.......o.......o...o...o
..o..o...........o.....o..o.o.....
o..o.....oo.....o.o......o....o..o
.........o..o.o.o.o...o.o..o......
..........oo..o.....o..o.o........
..o...o.o..o........o.............
ooo..o.....o....oo.........o......
........o..o........o.o........o..
.o.........oo.oo..o.o...oo.....o..
..oo...o.....o.o..oo........oo..o.
