137
oo..o..oo.oo.o...o..o..oo....oo...
.o....o...o..o.o.oo...oo.ooo..oooo
.oo.o.oo..o.o..o.o..o....oooo.o...
..o.oo..o..o.o...o..o.oo.o...o.o.o
oo..oo.o.........o....oo.o..o.....
.....o.....o.oo...oo...ooo....o...
o...o....o.o.oo....o..o......o....
.........oo.oo......o..o.o.o..oooo
.o...oo..o.ooooo..o...o...oo..o..o
.ooo....oooo..ooo..o...o..oo......
oo.o.oooo........oo........o.oo..o
o..o.oo....ooooo.o....oo.o.ooooooo
.o.o...o...ooo....o....oo.......oo
o.oo..oo.o..o.o...o.oo..o..o...o.o
o.o.o..o..o..o.oo......oo.o.....o.
...o.o.....o..ooo.o...o.o........o
.o...oo..o..o.o....o....o..oo....o
o.o.o.o...o....oo..oo.ooooo......o
o.o.o.o.o......oo.o......o..o...oo
..oo...ooooo....o.oo.o..o..o.o...o
.....oo....oooooo......o.........o
........o.o..oo.oo.o..o.o.oo..o..o
.o.....o..o..oo....oo.ooo..o...o.o
.o.............o....o..o...o..o...
....o.o.o.o.oo..ooo.oo.oo..o.oo..o
oo..o.....o......o...o.ooo..o.o...
o....oo....oooo..........o..o..o..
.ooo...oo..o..o..........oo.oo....
ooo.o..ooo...oo.....oo...oo..oo.o.
....oooo....o...o....o...oooo.....
.oo.o.ooo..o..o.o.oo..o....o...o.o
oo...o.oo.ooooo.o.o.o.oooo......o.
.....o.o.o...ooooo.o..o.oo....oooo
oo...o.o.oo.o.oo.o....oo..ooo...oo
.oo....o.o....ooooo.o....oooooo.o.
.o....o...o.o.....o....o....o.o...
.o.o.oo.o.o...o..o......o.o.....o.
..o.......ooo....oo.............oo
.......o...ooooo.o....oo..o..oo...
..o...o..o.......oo....oo..o.oo...
ooo....oo...........o.oooo.oooooo.
.o.oo.ooo..oo.o.o..ooo..oo.oo.oooo
.......ooo.oo...o.....oo.o....oo..
..ooo...o..o...oo....oo..oo.o.ooo.
o.o.....o...o....o.ooo.......o.o..
.oo...o......oo..oo...oo........oo
o.oo......o.oo.o.....o.oo.o.o..o..
.oo...oo.........o..o.ooo....oo..o
o...o....o....o..o...o..o.o..ooo..
..o..o.o.o...o.....o...oo..oo.....
.ooo.oo.....o.o.oo..oo........o..o
o.oo...oo.oooo...o..........oo.oo.
...o...o.o.o......o.o..........oo.
.....o.......o.ooo.........ooo.ooo
.o.o..o.o.........oo....o.o...o..o
oo..oo....o.......o...o.o......oo.
.oo..oo.o........oo.......oo..o..o
.o.o.....o..o..o...oo.o.oo....o.o.
.oo..ooo.oo.o.o.oo.o.ooooo......o.
...o.o....o....o....o..o.....o.o.o
........o.oo.o...oo.o..o.oo......o
o...o.......ooo.o...o....oo.o...o.
...o...oo..oo...o.......o.ooo.....
..o..o...o.o.....o...o.ooo.o.o...o
.....o....oo..oo...o.....oooo...oo
o.oo....oo....o..o....oo..oo..oo..
.ooooooo.........o..o.....o.o.o.o.
...oo..oo..o.......o..ooo..o..oo..
oooooo.o......o....ooo...oo.o...o.
.oo.......oo.o....o..o.o...o.....o
..o..o..o..oo.o.o...o....oo..o....
....oo...o..o...o.o.oo.o.o........
oo..o..o...o........oo...o.o.....o
o..oooo......o.....oo.o..o.....ooo
.......o....o.o..o...o....ooo.o.o.
.o.....oo..oo....oooooo...oooo....
......oo.oo..o........o..........o
oo..o..o.oo...oo.o.......ooo.o..o.
.o.o..o...oo...o....o....oo.o...o.
....oo.o..oooo.o.o......o.oo.o..oo
oo.o.oo....o..ooooo..oo..o...o....
ooo.....o.o..oo..o...o..oo.o.o...o
o.....oo....o....o........o..oo..o
.oooo...ooooo....o...oo.ooo..o....
o.oo.......o...oo.o..o.....o...o..
........o...........o..oo....o....
o..o.o...oooo.o.o.o.oooo..o.ooo.oo
ooo..o..o...oo...o......oo.o..oo..
oo...oo...ooo.....o.oo.o.....o....
.o.oo..o.o.o..oo.oo.oo....o..o....
.oo.o.o.ooo..oo.o...ooo....o.o.o..
..o..o.....o..o....oo.o..o.oo.o...
.........o.o..ooo............ooo..
o...o.o.oo..o....o......o..o.....o
...o....oo.....o..oo.o....o..oo..o
..o....o.........oo.o....o.ooooo..
o.o..o.oo.o..o.....oo.........oo..
......oooooooo.o...o...o.o..o...oo
.o....o..o.o.o.o....o....oo..oo..o
...ooo..oo.....o..oo.......oo.....
..o.o.o...o....o....o.o.o.o..o..o.
.o.o....o..o....o.o...o....oo...o.
o.oo......oo.o...ooo..oo.o.o.oo...
oo.oo.o.o.ooo..o.o.o...o..........
.o...o.o....o......oo.o..oo...o...
.o.....oo.oo.o..o...o......o..o...
ooo....o.o.o....oo.ooo.....oo..oo.
..oo........oo.o...ooo.o.oo.oo..o.
o.o..o...ooo.o.o....o..........oo.
.oo..o.oo.o..o......oo.ooo.o...oo.
.oo.oo...o.o.oo.o......oo.o..oo.oo
....o...o..o..o.o..o.o..o.oo.ooo.o
o.o...oo.o...o...oo.o........oo.oo
.oo..o.......ooooo.o..o.o....o....
.o.oo.oo..oo.ooo.o........o.ooo.o.
o.....o....o...ooo..oo.oo....o..o.
.....o..o..oo....o...o..o........o
ooo..........o..oo..o.o..o....oo..
..o.o..oo....o.o.....o...o.....o..
...o.o..o.....o....o..o...o.o...o.
.o....o...o..ooo..oo.o.o.o..o....o
.oo....o.oooooo...o..oooo.........
o.o...ooo.ooo........o.........o..
...oo.....oo.oo..oo......o..oo...o
ooo..oo.oo...o.o.o...o.o.o.o.o..oo
o.......o.ooo.o...o....oo...oo...o
....o....o............ooo....o.o.o
..o.oooo...o..........ooo...o....o
o....o.o..ooo..o..ooo..o..o.o.o.o.
..oo........o....o.o.oo.....o.....
o....oo...oo....o.....o.oo..o.o...
.....ooo.oo.....oo.o.....o.o..o...
.......o...oo...o..o..oo...oo....o
oo....o.o...o..o.o....o...o..o.o..
oo...oo.....o.o.o..o..oo.o...o..oo
..ooo...ooooo......oo.....ooo.o.o.
...o.o....oo..o.....o.oooo....o..o
