OOOOOOOOO
O       O
O  XX P O
O  XX   O
O      #O
OOOOOOOOO
