    #####
    #   #
    #   #
  ###   ###
  #   X   #
### # ### #     ######
#   # ### #######  OO#
#              X   OO#
##### #### #P####  OO#
    #      ###  ######
    ########
