#####
#   P O #
.###    #
#  #    #
#    XX #
P##     #
###Q#####
